wwwwwwwwwwwwwwwwwwwwwwwwwwwwwww
w   w                         w
w   w                    w    w
w  w      w       w     w     w
w w               w           w
ww   w     w      w   w       w
w      w     w    w           w
w    w     w         w        w
w   w           w             w
w   w       wwwwwwwwwwwwwwwwwww
w   w                       w w
w               w    w        w
w                    w        w
w    www    w   w    w        w
w       w            w        w
w w      w w  w  w   w  w  w  w
w         w          w        w
w    w     w    w             w
w    w      w                 w
w    w       w                w
w    w       w                w
w    w       w                w
w    w       w                w
w    w       w                w
w    w       w                w
w    w       w                w
w    w       w                w
w w      w w  w  w   w  w  w  w
w w      w w  w  w   w  w  w  w
w    w       w                w
w    w       w                w
w    w       w                w
w    w       w                w
w    w       w                w
w    w       w                w
w    w       w                w
w    w       w                w
w    w       w                w
w    w       w                w
w    w       w                w
w    w       w                w
w    w       w                w
wwwwwwwwwwwwwwwwwwwwwwwwwwwwwww