wwwwwwwwwwwwwwwwwwww
w                  w
w            w     w
w      bbb    w    w
w             w    w
w      bbb    w    w
w            w     b
w                  b
w                  b
w                  b
w                  w
w      w           w
w  w           b   w
w            w     w
w     w   b        w
w  w           w   w
w       b   w      w
w     w         w  w
w        w         w
w                  w
w                  w
w                  w
w                  w
w    www           w
w                  w
w                  w
w          bbb     w
w                  w
w     www          w
wwwwwwwwwwwwwwwwwwww