bbbbbbbbbbbbbbbbbbbb
b                  b
b            w     b
b      www    w    b
b             w    b
b      www    w    b
b            w     b
b                  b
b                  b
b                  b
b                  b
b      w           b
b  w           w   b
b            w     b
b     w   w        b
b  w           w   b
b       w   w      b
b     w         w  b
b        w         b
b                  b
b                  b
b                  b
b                  b
b    www           b
b                  b
b                  b
b          www     b
b                  b
b     www          b
bbbbbbbbbbbbbbbbbbbb