30 20 15 10 90
wwwwwwwwwwwwwwwwwwwwwwwwwwwwww
w   w                        w
w  w      w       w     w    w
w w               w          w
ww   w     w      w   w      w
w      w     w    w          w
w    w     w         w       w
w   w           w            w
w   w       wwwwwwwwwwwwwwwwww
w   w                        w
w               w    w       w
w                    w       w
w    www    w   w    w       w
w       w            w       w
w w      w w  w  w   w  w w  w
w         w          w       w
w    w     w    w            w
w    w      w                w
w    w       w               w
wwwwwwwwwwwwwwwwwwwwwwwwwwwwww